NO ./textures/nether/north.xpm
SO ./textures/nether/south.xpm


WE ./textures/nether/west.xpm
EA ./textures/nether/east.xpm
C 0,0,45
F 69,69,110
FE 0
FC 0,0,0

            1111111
         111110001111
         1100000000111
        111000011111111111
       111001111        111
 1111111000111           111
 11000011000111          111   
 1100001110000111        1111
 110000110000011111111111111
 1100001100000000000000000011
 1100000100000000000000000001
 1100000C0000000W000000000011
 110000110000000000000000001
 110001110000000000000000001
  11111111C00011111111101111
        1100000111 111100111
        1100000011  11000111
        1100000001   1000001
        1111111111   1111111
