NO ./textures/castle/north.xpm
SO ./textures/castle/south.xpm
WE ./textures/castle/west.xpm
EA ./textures/castle/east.xpm

F 207, 206, 204
C 128, 128, 128

111111111111111111111111111111111111111
1S1000000000111100000001000010000110011
101010111010000000000111110111110111011
101110101010100011100000000000110000011
101000100010100000000100000100101010111
101010110010111000111101010100101010111
101010100010100101101101111000111110001
101010100010100000100001111111101110011
100000110010110001111000011100000001001
111111111111111111111111111111111111111