NO ./textures/nether/north.xpm
SO ./textures/nether/south.xpm
WE ./textures/nether/west.xpm
EA ./textures/nether/east.xpm

F 110, 35, 35
C 80, 80, 80

111111111111111111111111111111111111111
1S1000000000111100000001000010000110011
101010111010000000000111110111110111011
101110101010100011100000000000110000011
101000100010100000000100000100101010111
101010110010111000111101010100101010111
101010100010100101101101111000111110001
101010100010100000100001111111101110011
100000110010110001111000011100000001001
101000100010100000000100000100101010111
101010110010111000111101010100101010111
101010100010100101101101111000111110001
101010100010100000100001111111101110011
100000110011110001111000011100000001001
101010100000100000100001111111101110011
100000110010110001111000011100000001001
101010000010000000000001111111111110011
100000110010110001111000000000000000001
111111111111111111111111111111111111111