NO ./textures/basic/north.xpm
SO ./textures/basic/south.xpm
WE ./textures/basic/west.xpm
EA ./textures/basic/east.xpm

F 255,0,0
C 0,0,255
FC 255, 255, 255
FT 10

11111111111111
100000E0000001
10000001000001
10000000000001
11111111111111