NO ./textures/cave/north.xpm
SO ./textures/cave/south.xpm
WE ./textures/cave/west.xpm
EA ./textures/cave/east.xpm

F 100, 100, 100
C 60, 60, 60
FC 0, 0, 0
FE 1

111111111111111111111111111111111111111
101000000000111100000001000010000110011
101010111010000000000111110111110111011
101110101010100011100000000000110000011
1010001000101N0000000100000100100010111
101010110010111000111101010100101010111
101010100010100101101101111000111110001
101010100010100000100001111111101110011
100000110010110001111000011100000001001
111111111111111111111111111111111111111
