NO ./textures/cave/north.xpm
SO ./textures/cave/south.xpm
WE ./textures/cave/west.xpm
EA ./textures/cave/east.xpm

F 100, 100, 100
C 60, 60, 60
FC 255, 255, 255
FT 100

1111111111111111111111111111
1010001000101N00000001000001
1010101100101110001111010101
1000000000000000000000000001111
1111111111111111111111111111111
